A	Alay
AA	Anadolu Ajansı
AADFI	AKBB
AAET	Avrupa Atom Enerjisi Topluluğu
AAFSE	GAMHK 
AB	Avrupa Birliği
ABB	Avrupa Birliği Bankası
ABD	Ana bilim dalı
ABGS	Avrupa Birliği Genel Sekreterliği
ABKF	Avrupa Bölgesel Kalkınma Fonu
ABÖ	Afrika Birliği Örgütü
ABS	Motorlu taşıtlarda fren sistemi 
ACU	ATB 
ACÜ	Acıbadem Üniversitesi
AÇSAP	Ana Çocuk Sağlığı ve Aile Planlaması Genel Müdürlüğü
ADB	AKB 
ADFD	ADKF 
ADKF	Abu Dabi Kalkınma Fonu
ADSL	Asimetrik sayısal abone hattı 
ADÜ	Adnan Menderes Üniversitesi
ADYÜ	Adıyaman Üniversitesi
AEGM	Kültür ve Turizm Bakanlığı Araştırma ve Eğitim Genel Müdürlüğü
AEİBÖ	Avrupa Ekonomik İş Birliği Örgütü
AEK	BMAEK
AET	Avrupa Ekonomik Topluluğu
AEÜ	Ahi Evran Üniversitesi
AFAD	Afet ve Acil Durum Yönetimi Başkanlığı
AFFB	Avrupa Futbol Federasyonları Birliği
AFİF	Akaryakıt Fiyat İstikrar Fonu
AFP	FBA 
age.	Adı geçen eser
AGİK	Avrupa Güvenlik ve İş Birliği Konferansı
AGİT	Avrupa Güvenlik ve İş Birliği Teşkilatı
AGM	Ağaçlandırma ve Erozyon Kontrolü Genel Müdürlüğü
agm.	Adı geçen makale
agy.	Adı geçen yayın
AI	UAT 
AİBÖ	Avrupa İş Birliği Örgütü
AİBÜ	Abant İzzet Baysal Üniversitesi
AİÇÜ	Ağrı İbrahim Çeçen Üniversitesi
AID	UKA 
AIDS	Edinilmiş bağışıklık yetersizliği belirtisi 
AİHAD	Avrupa İnsan Hakları Adalet Divanı
AİHM	Avrupa İnsan Hakları Mahkemesi
AİHS	Avrupa İnsan Hakları Sözleşmesi
AİK	Afrika İktisat Komisyonu
AİKB	Avrupa İmar ve Kalkınma Bankası
AİPB	Avrupa İktisadi ve Parasal Birliği
AK	Avrupa Konseyi
AKB	Afrika Kalkınma Bankası
AKBB	Afrika Kalkınma Bankaları Birliği
AKBİL	Akıllı bilet
AKÇT	Avrupa Kömür ve Çelik Topluluğu
AKD	Akdeniz Üniversitesi
AKDTYK	Atatürk Kültür, Dil ve Tarih Yüksek Kurumu
AKM	Atatürk Kültür Merkezi
AKPM	Avrupa Konseyi Parlamenterler Meclisi
AKUT	Arama Kurtarma Teşkilatı
AKÜ	Afyon Kocatepe Üniversitesi
ALADI	LABB
Alb.	Albay
ALES	Akademik Personel ve Lisanüstü Eğitimi Giriş Sınavı
Alm.	Almanca
AMB	Amerika Merkez Bankası
AMEX	AB 
AMF	APF 
AMK	Amerikan Merkez Komutanlığı
ANAM	Avrupa Nükleer Araştırma Merkezi
anat.	Anatomi
ANAÜ	Anadolu Üniversitesi
ANT	Akaryakıt İkmal ve Nato Pol Tesisleri İşletme Başkanlığı
ant.	Antropoloji
AO	Anonim ortaklık
AOÇ	Atatürk Orman Çiftliği
AÖB	Avrupa Ödemeler Birliği
AÖF	Açıköğretim Fakültesi
AP	ABD Haber Ajansı 
APA	Avrupa Para Anlaşması
APB	Avrupa Para Birliği
APE	Avrupa Para Enstitüsü
APEC	APİİB 
APF	Arap Para Fonu
APİİB	Asya Pasif ik İktisadi İş Birliği
APÖ	Avrupa Parlamenterler Örgütü
APS	Acele Posta Servisi
Apt.	Apartman, apartmanı
Ar.	Arapça
AREL	İstanbul Arel Üniversitesi 
AR-GE	Araştırma geliştirme
ark.	Arkeoloji
Arş. Gör.	Araştırma Görevlisi
As.	Asker, askerî, askerlik
As. İz.	Askerî İnzibat
ASAL	Asker Alma Dairesi Başkanlığı
Asb.	Astsubay
ASEAN	GAUT
ASELSAN	Askerî Elektronik Sanayii
ASF	Avrupa Sosyal Fonu
ASİGM	Adli Sicil ve İstatistik Genel Müdürlüğü
ASK	Avrupa Standartlar Komitesi
ASKİ	Ankara Su ve Kanalizasyon İdaresi
ASO	Ankara Sanayi Odası
AST	Ankara Sanat Tiyatrosu
ASTB	Amerika Serbest Ticaret Bölgesi
astr.	Astronomi
astrol.	Astroloji
ASÜ	Aksaray Üniversitesi
AŞ	Anonim şirket
AŞTİ	Ankara Şehirler Arası Terminal İşletmesi
AT	Avrupa Topluluğu
ATAD	Avrupa Toplulukları Adalet Divanı
ATAM	Atatürk Araştırma Merkezi
ATATÜRK	ÜNİ Atatürk Üniversitesi
ATB	Asya Takas Birliği
Atğm.	Asteğmen
ATK	Adli Tıp Kurumu
atm.	Atmosfer
ATO	Ankara Ticaret Odası
ATÜ	Atılım Üniversitesi
ATYGF	Avrupa Tarımsal Yönlendirme ve Garanti Fonu
AUA	Avrupa Uzay Ajansı
AÜ	Ankara Üniversitesi
Av.	Avukat
AVM	Alışveriş merkezi
AYB	Avrupa Yayın Birliği
AYİM	Askerî Yüksek İdare Mahkemesi
AYM	Anayasa Mahkemesi
B	Batı
BADET	Batı Afrika Devletleri Ekonomik Topluluğu
BAE	Birleşik Arap Emirlikleri
bağ.	Bağlaç
BAĞ-KUR	Esnaf ve Sanatkârlar ve Diğer Bağımsız Çalışanlar Sosyal Sigortalar Kurumu
BAKB	Batı Afrika Kalkınma Bankası
BASAGM	Başbakanlık Aile ve Sosyal Araştırmalar Genel Müdürlüğü
BAT	TBB 
BATO	Batı Afrika Takas Odası
BAU	Bahçeşehir Üniversitesi
BAÜN	Balıkesir Üniversitesi
BAY	ÜNİ Bayburt Üniversitesi
BBC	İngiliz Radyo Televizyon Kurumu 
BCG	Verem aşısı 
Bçvş.	Başçavuş
BD	Bilim dalı
BDDK	Bankacılık Düzenleme ve Denetleme Kurulu
BDT	Bağımsız Devletler Topluluğu
BE	Büyükelçi
BERD	AİKB 
BEÜ	Bitlis Eren Üniversitesi
BİB	Bayındırlık ve İskân Bakanlığı
BİK	Basın İlan Kurumu
BIS	UÖB 
bit. b.	Bitki bilimi
biy.	Biyoloji
bk.	Bakınız
bl.	Bilişim
Bl.	Bölük
BM	Birleşmiş Milletler
BMAEK	Birleşmiş Milletler Avrupa Ekonomik Komisyonu
BMÇYT	Birleşmiş Milletler Çocuklara Yardım Teşkilatı
BMEBKT	Birleşmiş Milletler Eğitim, Bilim ve Kültür Teşkilatı
BMSKÖ	Birleşmiş Milletler Sınai Kalkınma Örgütü
BMT	Birleşmiş Milletler Teşkilatı
BMTKK	Birleşmiş Milletler Ticaret ve Kalkınma Konferansı
BMYRİ	Birleşmiş Milletler Yardım ve Rehabilitasyon İdaresi
Bn.	Bayan
Bnb.	Binbaşı
BOAD	BAKB
BOREN	Ulusal Bor Araştırma Enstitüsü
BOTAŞ	Boru Hatları ile Petrol Taşıma Anonim Şirketi
Böl.	Bölüm
BRT	Bartın Üniversitesi
bs.	Baskı, basım
BSEC	KEİ 
BSTDB	KTKB
Bşk.	Başkan, başkanlık, başkanı, başkanlığı
BTF	Başbakanlık Tanıtma Fonu Kurulu
BTK	Bilgi Teknolojileri ve İletişim Kurumu
BTÜ	Bursa Teknik Üniversitesi 
BUE	ABB 
Bul.	Bulvar, bulvarı
Bulg.	Bulgarca
BÜ	Başkent Üniversitesi
BÜMKO	Bütçe ve Mali Kontrol Genel Müdürlüğü
BVÜ	Bezmiâlem Vakıf Üniversitesi
BYEGM	Basın-Yayın ve Enformasyon Genel Müdürlüğü
C	Cilt
CACM	OAOP 
Cad.	Cadde, caddesi
CAEC	AKPM 
CAO	SHÖ 
CARICOM	KTOP
CBÜ	Celâl Bayar Üniversitesi
CC	Konsolosluk birimi 
CD	Kordiplomatik 
CDB	KKB 
CDH	AİHAD 
CE	AK 
CEAP	APİİB 
CECA	AKÇT 
CEDH	AİHM 
CEE	AET 
CEI	BDT 
CEN	ASK
CENTCOM	AMK
CENTO	MAÖ 
CERN	ANAM 
CGS	Uluslararası f izik birimleri sistemi
CIA	MHAT 
CIF	Maliyet-sigorta-navlun 
CİGM	Ceza İşleri Genel Müdürlüğü
CIJ	UAD 
CIOS	UBOK 
CIP	Taşıma ve sigorta bedeli ödenmiş olarak teslim
CIS	BDT 
CJCE	ATAD 
cm	Santimetre
CMEA	KEYK 
CMK	Ceza Muhakemesi Kanunu
CMUK	Ceza Muhakemeleri Usulü Kanunu
CNRS	UBAM 
coğ.	Coğrafya
COMCEC	İSEDAK
COMECON	KEYK 
COMESA	GDAOP 
cos	Kosinüs
CSO	Cumhurbaşkanlığı Senfoni Orkestrası
CTC	UŞM 
CTE	Ceza ve Tevkifevleri Genel Müdürlüğü
Cum.Bşk.	Cumhurbaşkanı, Cumhurbaşkanlığı
CÜ	Cumhuriyet Üniversitesi
ÇAĞ	ÜNİ Çağ Üniversitesi
ÇASGEM	Çalışma ve Sosyal Güvenlik Eğitim ve Araştırma Merkezi
ÇAYKUR	Çay İşletmeleri Genel Müdürlüğü
ÇED	Çevresel Etki Değerlendirmesi ve Planlama Genel Müdürlüğü
çev.	Çeviren
ÇGM	Çalışma ve Sosyal Güvenlik Bakanlığı Çalışma Genel Müdürlüğü
ÇNÜ	Çankırı Karatekin Üniversitesi
ÇOMÜ	Çanakkale Onsekiz Mart Üniversitesi
ÇS	Çimento Sanayisi
ÇSGB	Çalışma ve Sosyal Güvenlik Bakanlığı
ÇUKOBİRLİK	Çukurova Pamuk Tarım Satış Kooperatif leri Birliği
ÇÜ	Çankaya Üniversitesi
Çvş.	Çavuş
ÇYGM	Çevre Yönetimi Genel Müdürlüğü
D	Doğu
DAGM	Devlet Arşivleri Genel Müdürlüğü
DAKB	Doğu Afrika Kalkınma Bankası
dal	Dekalitre
dam	Dekametre
DAP	Doğu Anadolu Projesi
DAT	Doğu Afrika Topluluğu
DB	Dünya Bankası
db.	Dil bilgisi
DBAFİT	Dünya Bankalar Arası Finansal İletişim Topluluğu
DDB	Dernekler Dairesi Başkanlığı
DDT	Böcek öldü-rücü 
DDY	Devlet Deniz Yolları
DESİYAB	Devlet Sanayi ve İşçi Yatırım Bankası
DEÜ	Dokuz Eylül Üniversitesi
DFİF	Destekleme ve Fiyat İstikrar Fonu
DFMHÖ	Dünya Fikrî Mülkiyet Hakları Örgütü
dg	Desigram
DGK	Dünya Gıda Konseyi
DGM	Devlet Güvenlik Mahkemesi
DGÖ	Dünya Gümrük Örgütü
DGS	Dikey Geçiş Sınavı
DHMİ	Devlet Hava Meydanları İşletmesi 
DİB	Diyanet İşleri Başkanlığı
DİE	Devlet İstatistik Enstitüsü
dil b.	Dil bilimi
DİYİH	Çalışma ve Sosyal Güvenlik Bakanlığı Dış İlişkiler ve Yurt Dışı İşçi Hizmetleri Genel Müdürlüğü
dk.	Dakika
DKK	Deniz Kuvvetleri Komutanlığı
DKMP	Doğa Koruma ve Millî Parklar Genel Müdürlüğü
dl	Desilitre
DLH	Demiryollar Limanlar ve Hava Meydanları İnşaatı Genel Müdürlüğü
dm	Desimetre
DMİ	Devlet Meteoroloji İşleri Genel Müdürlüğü
DMO	Devlet Malzeme Of isi
DNA	Deoksirübo nükleik asit
DOBGM	Devlet Opera ve Balesi Genel Müdürlüğü
Doç.	Doçent
doğ.	Doğum tarihi
DOÜ	Doğuş Üniversitesi
DÖGM	Din Öğretimi Genel Müdürlüğü
DÖSİM	Kültür ve Turizm Bakanlığı Döner Sermaye İşletmesi Merkez Müdürlüğü
DPB	Devlet Planlama Başkanlığı
DPT	Devlet Planlama Teşkilatı Müsteşarlığı
DPÜ	Dumlupınar Üniversitesi
Dr.	Doktor
drl.	Derleyen
DSİ	Devlet Su İşleri Genel Müdürlüğü
DSO	Devlet Sanayi Of isi
DSÖ	Dünya Sağlık Örgütü
DT	Devlet Tiyatroları Genel Müdürlüğü
DTCF	Dil ve Tarih-Coğrafya Fakültesi
DTM	Dış Ticaret Müsteşarlığı
DTÖ	Dünya Ticaret Örgütü
DÜ	Dicle Üniversitesi
DVD	SYD 
Dz. Kuv. K.	Deniz Kuvvetleri Komutanı, Komutanlığı
Dz. Kuv.	Deniz Kuvvetleri
dzl.	Düzenleyen
E	Eczane
EAC	AİBÖ 
EADB	DAKB 
EAEC	AAET 
EAGGF	ATYGF 
EAT	Eski Anadolu Türkçesi
EBK	Et ve Balık Kurumu Genel Müdürlüğü
EBRD	AİKB (European Bank for Reconstruction and Development
EBU	AYB 
EBWE	AİKB 
EC	AT 
ECB	AMB 
ECE	BMAEK 
ECHR	AİHM 
ECJ	ATAD 
ECLA	LAKEK 
ECOWAS	BADET 
ECSC	AKÇT 
Ecz.	Eczacı
ed.	Edebiyat
EEC	AET 
EEG	Beyin akım graf iği 
EFT	Bankalar arası para aktarımı 
EFTA	ASTB 
EGM	Emniyet Genel Müdürlüğü
EGMR	AİHM 
EGO	Ankara Belediyesi Elektrik, Gaz, Otobüs İşletmeleri
EĞİTEK	Eğitim Teknolojileri Genel Müdürlüğü
EIB	AYB 
EİBKT	Ekonomik İş Birliği ve Kalkınma Teşkilatı
EİBÖ	Ekonomik İş Birliği Örgütü
EİEİ	Elektrik İşleri Etüt İdaresi Genel Müdürlüğü
EKG	Kalp akım graf iği 
ekon.	Ekonomi
EMG	Kas akım graf iği 
EMI	APE 
EMK	Elektromotor kuvvet
EMU	AİPB 
Ens.	Enstitü, enstitüsü
EPA	APÖ 
EPDK	Enerji Piyasası Düzenleme Kurulu
EPU	AÖB 
ERDEMİR	Ereğli Demir Çelik Fabrikaları
ERDF	ABKF 
Erm.	Ermenice
ERÜ	Erciyes Üniversitesi
ESA	AUA 
ESF	ASF 
ESGM	Esnaf ve Sanatkârlar Genel Müdürlüğü
ESHOT	İzmir Belediyesi Elektrik, Su, Hava Gazı, Otobüs, Tramvay İşletmeleri
ESOGÜ	Eskişehir Osmangazi Üniversitesi
ET	Eski Türkçe 
ETKB	Enerji ve Tabii Kaynaklar Bakanlığı
ETOGM	Erkek Teknik Öğretim Genel Müdürlüğü
EU	AB 
EuGH	ATAD 
EURATOM	AAET 
EÜ	Ege Üniversitesi
EÜAŞ	Elektrik Üretim Anonim Şirketi
EWG	AET 
EXİMBANK	Türkiye İhracat ve Kredi Bankası
f.	Fiil
F	Fiyat
FAB	Federal Araştırma Bürosu
FAC	YİBF
Fak.	Fakülte
Fak-Fuk	Fon Sosyal Yardımlaşma ve Dayanışmayı Teşvik Fonu
FAO	GTÖ 
Far.	Farsça
FBA	Fransız Basın Ajansı
FBI	FAB 
fel.	Felsefe
FIBA	UBF 
FIDE	USF 
FIDES	İSKYF
FIFA	UFF 
fil.	Filoloji, f ilolojisi
FILA	UAGF 
FIR	Uçuş hattı düzenlemesi 
FİSKOBİRLİK	Fındık Tarım Satış Kooperatifleri Birliği
fiz.	Fizik
fizy.	Fizyoloji
FKB	Fizik, kimya, biyoloji
FM	Frekans modülasyonu 
FMVIÜ	Işık Üniversitesi
fob	Malın belirlenen limanda gemi üzerindeki teslim f iyatı 
Fr.	Fransızca
FRB	AMB 
FSMVÜ	Fatih Sultan Mehmet Vakıf Üniversitesi
FTAA	ASTB 
FÜ	Fırat Üniversitesi
g	Gram
G	Güney
GAMHK	Güney Avrupa Müttefik Hava Kuvvetleri
GAP	Güneydoğu Anadolu Projesi
GAPBKİ	GAP Bölge Kalkınma İdaresi Başkanlığı
GATA	Gülhane Askerî Tıp Akademisi
GAUT	Güneydoğu Asya Uluslar Topluluğu 
GAZÜ	Gaziantep Üniversitesi
GB	Bilgisayarda bellek birimi 
GBT	Genel Bilgi Taraması
GD	Güneydoğu
GDAOP	Güney ve Doğu Afrika Ortak Pazarı
Gen.	General
geom.	Geometri
GİB	Gelir İdaresi Başkanlığı
GİGM	Başbakanlık Güvenlik İşleri Genel Müdürlüğü
gn.	Genel
Gnkur.	Genelkurmay
GOÜ	Gaziosmanpaşa Üniversitesi
Gön.	Gönderen
gr.	Gramer
Grt	Groston
GSGM	Gençlik ve Spor Genel Müdürlüğü
GSM	Mobil cep telefonu 
GSMH	Gayrisafi millî hasıla
GSÜ	Galatasaray Üniversitesi
GSYH	Gayrisafi yurt içi hasıla
GTÖ	Gıda ve Tarım Örgütü
GUS	BDT 
GÜ	Gazi Üniversitesi
GYD	Görüntülü yoğun disk
GYTE	Gebze Yüksek Teknoloji Enstitüsü
GZK	Gazikent Üniversitesi
H	Hicri
HA	Harp Akademisi
HABITAT	Birleşmiş Milletler İnsan Yerleşimleri Konferansı 
HACCP	Kritik kontrol noktalarında tehlike analizi
HAVAŞ	Hava Alanları ve Yer Hizmetleri Genel Müdürlüğü
hay. b.	Hayvan bilimi
haz.	Hazırlayan
HDD	Ana bellek sürücüsü 
hek.	Hekimlik, hekim, hekimi
HGK	Harita Genel Komutanlığı
HGM	Haberleşme Genel Müdürlüğü
HIV	AIDS hastalığına neden olan virüs 
HİTÜ	Hitit Üniversitesi
HKK	Hava Kuvvetleri Komutanlığı
hl	Hektolitre
hlk.	Halk ağzı
HM	Hazine Müsteşarlığı
hm	Hektometre
HMUK	Hukuk Muhakemeleri Usulü Kanunu
HO	Harp Okulu 
HRÜ	Harran Üniversitesi
Hs. Uzm.	Hesap Uzmanı
HSSGM	Sağlık Bakanlığı Hudut ve Sahiller Sağlık Genel Müdürlüğü
HUK	Maliye Bakanlığı Hesap Uzmanları Kurulu Başkanlığı
huk.	Hukuk
HÜ	Hacettepe Üniversitesi
Hv. Kuv. K.	Hava Kuvvetleri Komutanı, Komutanlığı
Hv. Kuv.	Hava Kuvvetleri
Hz. öz.	Hizmete özel
Hz.	Hazret, Hazreti
IĞDÜ	Iğdır Üniversitesi
IAAF	UAAF 
IAEA	UAEA 
IATA	UHTB 
İAÜ	İstanbul Aydın Üniversitesi
IBEC	UEİBB 
İbr.	İbranice
IBRD	UİKB 
İBÜ	İstanbul Bilim Üniversitesi
İBÜN	İstanbul Bilgi Üniversitesi
ICAO	USHÖ 
ICC	UTO 
ICIC	UHİK 
ICJ	UAD 
ICRC	UKK 
ICSID	UYAÇM 
IDA	UKA 
IDB	İKB 
İDBÜ	İhsan Doğramacı Bilkent Üniversitesi
İDT	İktisadi Devlet Teşekkülleri
IEA	UEA 
İEGM	İlaç ve Eczacılık Genel Müdürlüğü
İETT	İstanbul Elektrik, Tünel, Tramvay İşletmesi
İEÜ	İzmir Ekonomi Üniversitesi
IFAD	UTKF 
IFC	UFK 
IFOAM	UETHF 
İGB	Başbakanlık İdareyi Geliştirme Başkanlığı
İGEME	İhracatı Geliştirme Etüd Merkezi
IGH	UAD 
İGM	İlköğretim Genel Müdürlüğü
İHB	İnsan Hakları Başkanlığı
İKB	İslam Kalkınma Bankası
İKBÜ	İstanbul Kemerburgaz Üniversitesi
İKÖ	İslam Konferansı Örgütü
İKÜ	İstanbul Kültür Üniversitesi 
İKV	İktisadi Kalkınma Vakfı
İLBANK	İller Bankası Genel Müdürlüğü
ILO	UÇÖ 
IMF	UPF 
İMKB	İstanbul Menkul Kıymetler Borsası
IMO	UDÖ 
İng.	İngilizce
INTERPOL	Uluslararası Cinayet Polisi Komisyonu 
İO	İlköğretim okulu
IOC	UOK 
IPI	UBE 
IRO	UMT 
is.	İsim
ISBN	Uluslararası standart kitap numarası 
İSDEMİR	İskenderun Demir Çelik Fabrikaları
İSEDAK	İslam Konferansı Örgütü Ekonomik ve Ticari İş Birliği Daimî Komitesi
İSG	İş Sağlığı ve Güvenliği Genel Müdürlüğü
İSKİ	İstanbul Su ve Kanalizasyon İdaresi
İSKYF	İktisadi ve Sosyal Kalkınma Yatırım Fonları
ISMN	Uluslararası standart müzik numarası 
ISO	USÖ 
İSO	İstanbul Sanayi Odası
İsp.	İspanyolca
ISSN	Uluslararası standart dizi numarası 
İŞKUR	Türkiye İş Kurumu
işl.	İşleyen
İŞOT	İstanbul Şehirler Arası Otobüs Terminali
İt.	İtalyanca
İTB	İstanbul Ticaret Borsası
ITC	UTM 
İTG	İç Ticaret Genel Müdürlüğü
İTİCÜ	İstanbul Ticaret Üniversitesi
ITO	Birleşmiş Milletler Uluslararası Ticaret Birliği 
İTO	İstanbul Ticaret Odası
İTÜ	İstanbul Teknik Üniversitesi
İÜ	İnönü Üniversitesi
IWF	UPF 
İYTE	İzmir Yüksek Teknoloji Enstitüsü
İZTB	İzmir Ticaret Borsası
İZTO	İzmir Ticaret Odası
J	Jandarma
JAL	JHY 
Jap.	Japonca
jeol.	Jeoloji
JGK	Jandarma Genel Komutanlığı
JHY	Japon Hava Yolları 
K	Kuzey
kal	Kalori
KARDEMİR	Karabük Demir Çelik Fabrikaları
KASTB	Kuzey Amerika Serbest Ticaret Bölgesi
KAÜ	Kafkas Üniversitesi
KB	Kuzeybatı
KBB	Kulak, Burun, Boğaz
KBÜ	Karabük Üniversitesi
KD	Kuzeydoğu
KDV	Katma değer vergisi
KED	Kablosuz Erişim Düzeneği
KEGM	Kıyı Emniyeti Genel Müdürlüğü
KEİ	Karadeniz Ekonomik İş Birliği
KEYK	Karşılıklı Ekonomik Yardım Konseyi
kg	Kilogram
KGB	Sovyet Gizli Haber Alma Teşkilatı 
KGM	Adalet Bakanlığı Kanunlar Genel Müdürlüğü
KHK	Kanun hükmünde kararname
KHÜ	Kadir Has Üniversitesi
KHz	Kilohertz
KİBİB	Kalkınma İçin Bölgesel İş Birliği
KİK	Kamu İhale Kurumu
kim.	Kimya
KİT	Kamu İktisadi Teşekkülü
KİYÜ	Kilis 7 Aralık Üniversitesi
KKB	Karayip Kalkınma Bankası
KKGM	Tarım ve Köyişleri Bakanlığı Koruma ve Kontrol Genel Müdürlüğü
KKK	Kara Kuvvetleri Komutanlığı
KKTC	Kuzey Kıbrıs Türk Cumhuriyeti
KLÜ	Kırklareli Üniversitesi
km	Kilometre
KMS	Kurumlar İçi Merkezî Eleme Sınavı
KMÜ	Karamanoğlu Mehmetbey Üniversitesi
KOBİ	Küçük ve Orta Boy  İşletme
KOİ	Kamu Ortaklığı İdaresi
koor.	Koordinasyon
Kor.	Kolordu
Kora.	Koramiral
Korg.	Korgeneral
KOSGEB	Küçük ve Orta Ölçekli İşletmeleri Geliştirme ve Destekleme İdaresi Başkanlığı
KOÜ	Kocaeli Üniversitesi
KPDS	Kamu Personeli Yabancı Dil Bilgisi Seviye Tespit Sınavı
KPSS	Kamu Personel Seçme Sınavı
kr.	Kuruş 
krş.	Karşılaştırınız
KSDB	Kanserle Savaş Dairesi Başkanlığı
KSGM	Kadının Statüsü Genel Müdürlüğü
KSÜ	Kahramanmaraş Sütçü İmam Üniversitesi
KTKB	Karadeniz Ticaret ve Kalkınma Bankası
KTO-KÜ	KTO Karatay Üniversitesi
KTOP	Karayip Topluluğu ve Ortak Pazarı
KTÖGM	Kız Teknik Öğretim Genel Müdürlüğü
KTÜ	Karadeniz Teknik Üniversitesi
KUGM	Kara Ulaştırma Genel Müdürlüğü
Kur. Bşk.	Kurmay Başkanı, Başkanlığı
Kur.	Kurmay
KÜ	Kastamonu Üniversitesi
KVMGM	Kültür Varlıkları ve Müzeler Genel Müdürlüğü
KYGM	Kütüphaneler ve Yayımlar Genel Müdürlüğü
l	Litre
LABB	Latin Amerika Bütünleşme Birliği
LAFTA	LASTB 
LAIA	LABB 
LAKEK	Latin Amerika ve Karayipler Ekonomik Komisyonu
LASTB	Latin Amerika Serbest Ticaret Bölgesi
Lat.	Latince
LCV	Lütfen cevap veriniz
LES	Lisansüstü Eğitim Giriş Sınavı
LP	Uzunçalar 
LPG	Sıvılaştırılmış Petrol Gazı 
Ltd.	Limitet
LYS	Lisans Yerleştirme Sınavı
m	Metre
M	Miladi
Mac.	Macarca
Mah.	Mahalle, mahallesi
MAKÜ	Mehmet Akif Ersoy Üniversitesi
man.	Mantık
MAÖ	Merkezî Antlaşma Örgütü
MASAK	Mali Suçları Araştırma Kurulu Başkanlığı
mat.	Matematik
MAÜ	Mardin Artuklu Üniversitesi
MB	Maliye Bakanlığı
Md.	Müdür, müdürlük, müdürlüğü
MEB	Millî Eğitim Bakanlığı
mec.	Mecaz
MEÜ	Mersin Üniversitesi
MGK	Millî Güvenlik Kurulu Genel Sekreterliği
MGM	İçişleri Bakanlığı Mahalli İdareler Genel Müdürlüğü
MĞÜ	Muğla Üniversitesi 
MHAT	Merkezî Haber Alma Teşkilatı
MHz	Megahertz
MİGEM	Maden İşleri Genel Müdürlüğü
MİLE	Millî Emlak Genel Müdürlüğü
mim.	Mimarlık
min.	Mineraloji
MİT	Millî İstihbarat Teşkilatı Müsteşarlığı
MK	Medeni Kanun
MKB	Millî Kütüphane Başkanlığı
MKE	Makine ve Kimya Endüstrisi Kurumu
MKS	Metre-Kilogram-Saat
MKÜ	Mustafa Kemal Üniversitesi
MKYK	Merkez Karar Yönetim Kurulu
mm	Milimetre
MOBESE	Bölgesel güvenlik sistemi 
MOSSAD	İsrail Gizli Haber Alma Örgütü
MÖ	Milattan önce
MPİ	Millî Piyango İdaresi Genel Müdürlüğü
MPM	Millî Prodüktivite Merkezi
MR	Manyetik rezonans görüntüleme
MS	Milattan sonra
MSB	Millî Savunma Bakanlığı
MSGSÜ	Mimar Sinan Güzel Sanatlar Üniversitesi
MTA	Maden Tetkik ve Arama Genel Müdürlüğü
MÜ	Maltepe Üniversitesi
Müh.	Mühendis, mühendisi, mühendislik
Mür.	Müracaat
müz.	Müzik
MYK	Mesleki Yeterlilik Kurumu
NAFTA	KASTB 
NASA	Amerikan Ulusal Havacılık ve Uzay Araştırmaları Merkezi 
NATO	Kuzey Atlantik Antlaşması Teşkilatı 
NEÜ	Nevşehir Üniversitesi
NĞÜ	Niğde Üniversitesi
NKÜ	Namık Kemal Üniversitesi
No.	Numara
NOTAM	Havacılar ve denizciler için uyarı bildirimi 
Nö.	Nöbetçi
Nö. Sb.	Nöbetçi subayı
NVİGM	Nüfus ve Vatandaşlık İşleri Genel Müdürlüğü
OACI	USHÖ 
OAE	ABÖ 
OAİB	Orta Anadolu İhracatçı Birlikleri Genel Sekreterliği
OAOP	Orta Amerika Ortak Pazarı
OAPEC	PİEAÜÖ 
OAU	ABÖ  
OBESİD	Okul İçi Beden Eğitimi Spor ve İzcilik Dairesi Başkanlığı
OCDE	EİBKT 
OCI	İKÖ 
ODTÜ	Orta Doğu Teknik Üniversitesi
ODÜ	Ordu Üniversitesi
OECD	EİBKT 
OEEC	AEİBÖ 
OGM	Orman Genel Müdürlüğü
OIC	İKÖ 
OIEC	UİİBÖ 
OKAN	Okan Üniversitesi
OKÖNEGM	Okul Öncesi Eğitimi Genel Müdürlüğü
Okt.	Okutman
OKÜ	Osmaniye Korkut Ata Üniversitesi
OMC	DTÖ 
OMI	UDÖ 
OMÜ	Ondokuz Mayıs Üniversitesi
Onb.	Onbaşı
OPEC	PİEÜT 
OPEP	PİEÜT 
Opr.	Operatör
Or.	Ordu
Ora.	Oramiral
Ord.	Ordinaryüs
Org.	Orgeneral
ORKÖY	Orman-Köy İlişkileri Genel Müdürlüğü
Ort.	Ortaklık, ortakları, ortaklığı
OSB	Organize Sanayi Bölgesi
Osm. T.	Osmanlı Türkçesi
OSZE	AGİT 
OUA	ABÖ 
OYAK	Ordu Yardımlaşma Kurumu
OYEGM	Öğretmen Yetiştirme ve Eğitimi Genel Müdürlüğü
ÖÇKKB	Özel Çevre Koruma Kurumu Başkanlığı
ÖİB	Özelleştirme İdaresi Başkanlığı
öl.	Ölüm tarihi
ÖÖKGM	Özel Öğretim Kurumları Genel Müdürlüğü
ör.	Örnek
ÖRGM	Özel Eğitim Rehberlik ve Danışma Hizmetleri Genel Müdürlüğü
ÖSGM	Sanayi ve Ticaret Bakanlığı Ölçüler ve Standartlar Genel Müdürlüğü
ÖSS	Öğrenci Seçme Sınavı
ÖSYM	Ölçme, Seçme ve Yerleştirme Merkezi
ÖTV	Özel tüketim vergisi
ÖYK	Özelleştirme Yüksek Kurulu
ÖYS	Öğrenci Yerleştirme Sınavı 
öz.	Özel
ÖZİ	Özürlüler İdaresi Başkanlığı
ÖZÜ	Özyeğin Üniversitesi
PAÜ	Pamukkale Üniversitesi
ped.	Pedagoji
PEN	UYB 
PETKİM	Petrokimya Endüstrisi Genel Müdürlüğü
PİEAÜÖ	Petrol İhraç Eden Arap Ülkeleri Örgütü
PİEÜT	Petrol İhraç Eden Ülkeler Teşkilatı
PİGM	Petrol İşleri Genel Müdürlüğü
PK	Posta kutusu
PO	Petrol Of isi
POAŞ	Petrol Of isi Anonim Şirketi
Port.	Portekizce
Prof.	Profesör
psikol.	Psikoloji
PTT	Posta ve Telgraf Teşkilatı Genel Müdürlüğü
RAM	Bilgisayarda okunabilir ve yazılabilir bellek 
RC	Kızılhaç 
RCD	KİBİB 
RK	Rekabet Kurumu
RNA	Ribo nükleik asit
ROM	Bilgisayarda yalnızca okunabilir bellek 
Ro-Ro	Gemiye taşıt indirme bindirme 
RSHM	Ref ik Saydam Hıfzıssıhha Merkezi Başkanlığı
RTÜK	Radyo ve Televizyon Üst Kurulu
Rum.	Rumca
Rus.	Rusça
RÜ	Rize Üniversitesi
S	Sayı
s.	Sayfa
sa.	Saat
SAS	Su Altı Savunma 
SAT	Su Altı Taarruz 
SATEM	Savunma Sanayii ve Teknoloji Eğitim Merkezi
SAÜ	Sakarya Üniversitesi
Sb.	Subay
SB	Sağlık Bakanlığı
SBF	Siyasal Bilgiler Fakültesi
SBS	Seviye Belirleme Sınavı
SDIF	TMSF 
SDÜ	Süleyman Demirel Üniversitesi
SEFD Bşk.	Millî Savunma Bakanlığı Seferberlik Dairesi Başkanlığı
SEK	Süt Endüstrisi Kurumu Sanayi ve Ticaret Anonim Şirketi
SEKA	Selüloz ve Kâğıt Sanayii Kurumu 
sf.	Sıfat
SG	Sahil Güvenlik
SGK	Sosyal Güvenlik Kurumu
SGM	Sanayi ve Ticaret Bakanlığı Sanayi Genel Müdürlüğü
SHÇEK	Sosyal Hizmetler ve Çocuk Esirgeme Kurumu
SHGM	Sivil Havacılık Genel Müdürlüğü
SHÖ	Sivil Havacılık Örgütü
SİÜ	Siirt Üniversitesi
SKT	Son kullanma tarihi
Sl.	Slavca
SMWK	KEİ 
Sn.	Sayın
sn.	Saniye
snt.	Santral
SNÜ	Sinop Üniversitesi
Sok.	Sokak
SOS	Uluslararası yardım isteme uyarısı 
sos.	Sosyoloji
sp.	Spor
SPA	SUGES 
SPK	Sermaye Piyasası Kurulu
Srp.	Sırpça
SSCB	Sovyet Sosyalist Cumhuriyetleri Birliği
SSDB	Sağlık Bakanlığı Sıtma Savaş Dairesi Başkanlığı
SSK	Sosyal Sigortalar Kurumu
SSM	Savunma Sanayi Müsteşarlığı
STB	Sanayi ve Ticaret Bakanlığı
STK	Sivil Toplum Kuruluşu
STÖ	Sivil Toplum Örgütü
SUGES	Sudan gelen sağlık
SÜ	Sabancı Üniversitesi
SWIFT	DBAFİT 
SYD	Sayısal yoğun disk
SYDGM	Sosyal Yardımlaşma ve Dayanışma Genel Müdürlüğü
Ş	Şirket
Şb.	Şube
ŞEHİR	İstanbul Şehir Üniversitesi
ŞÜ	Şırnak Üniversitesi
t	Ton
T.	Türkçe
T.C.	Türkiye Cumhuriyeti
TAA	Türkiye Adalet Akademisi
TAEK	Türkiye Atom Enerjisi Kurumu
TAGEM	Tarımsal Araştırmalar Genel Müdürlüğü
TAI	THS 
TAPDK	Tütün ve Alkol Piyasası Düzenleme Kurulu
tar.	Tarih
TARİŞ	Tarım Satış Kooperatif leri Birliği
TASS	Sovyetler Birliği Telgraf Ajansı 
TAŞ	Türk Anonim Şirketi
TAU	Teknik Araştırma ve Uygulama Genel Müdürlüğü
Tb.	Tabur
TBB	Türkiye Bankalar Birliği
TBMM	Türkiye Büyük Millet Meclisi
TCDD	Türkiye Cumhuriyeti Devlet Demiryolları
TCK	Türkiye Cumhuriyeti Karayolları
TCMB	Türkiye Cumhuriyet Merkez Bankası
TCZB	Türkiye Cumhuriyeti Ziraat Bankası
TDÇİ	Türkiye Demir Çelik İşletmeleri
TDİ	Türkiye Denizcilik İşletmeleri
TDK	Türk Dil Kurumu
TEAE	Tarımsal Ekonomi Araştırma Enstitüsü
TEAŞ	Türkiye Elektrik Üretim Anonim Şirketi
TEDAŞ	Türkiye Elektrik Dağıtım Anonim Şirketi
TEDGEM	Teşkilatlanma ve Destekleme Genel Müdürlüğü
TEFE	Toptan eşya f iyatları endeksi
TEİAŞ	Türkiye Elektrik İletim Anonim Şirketi
TEK	Türkiye Elektrik Kurumu
tek.	Teknik, teknoloji
tel.	Telefon
telg.	Telgraf
TEM	Avrupa Transit Kara Yolu 
TEMSAN	Türkiye Elektromekanik Sanayii
TETAŞ	Türkiye Elektrik, Ticaret ve Taahhüt Anonim Şirketi
TFF	Türkiye Futbol Federasyonu Başkanlığı
TGC	Türkiye Gazeteciler Cemiyeti
TGM	Kültür ve Turizm Bakanlığı Tanıtma Genel Müdürlüğü
TGS	Türkiye Gazeteciler Sendikası
Tğm.	Teğmen
THA	Türk Haberler Ajansı
THK	Türk Hava Kurumu
THS	Türk Havacılık Sanayii
THSGM	Telif Hakları ve Sinema Genel Müdürlüğü
THY	Türk Hava Yolları
TIR	Uluslararası Kara Yolu Taşımacılığı 
tic.	Ticaret
TİGEM	Tarım İşletmeleri Genel Müdürlüğü
TİKA	Türk İş Birliği ve Koordinasyon Ajansı Başkanlığı
TİM	Türkiye İhracatçılar Merkezi
TİSK	Türkiye İşverenler Sendikası Konfederasyonu 
tiy.	Tiyatro
TK	BTK 
TKAE	Türk Kültürünü Araştırma Enstitüsü
TKB	Türkiye Kalkınma Bankası
TKGM	Tapu ve Kadastro Genel Müdürlüğü
TKİ	Türkiye Kömür İşletmeleri
TL	Türk lirası
tlks.	Teleks
tls.	Telsiz
TM	Türk malı
TMMOB	Türk Mühendis ve Mimar Odaları Birliği
TMO	Toprak Mahsulleri Of isi
TMSF	Tasarruf Mevduatı Sigorta Fonu
TMSK	Türkiye Muhasebe Standartları Kurulu
TNCÜ	Tunceli Üniversitesi
TOBB	Türkiye Odalar ve Borsalar Birliği
TOBB	ETÜ TOBB Ekonomi ve Teknoloji Üniversitesi
TODAİE	Türkiye ve Orta Doğu Amme İdaresi Enstitüsü
TOEFL	Yabancı dil olarak İngilizce testi 
TOKİ	Toplu Konut İdaresi Başkanlığı
Top.	Topçu
TÖMER	Türkçe Öğretim Merkezi
TP	Türk Petrolleri
TPAO	Türkiye Petrolleri Anonim Ortaklığı
TPE	Türk Patent Enstitüsü
TR	Türkiye
TRGM	Tarım Reformu Genel Müdürlüğü
TRKGM	Tüketicinin ve Rekabetin Korunması Genel Müdürlüğü
TRS	Toros Üniversitesi
TRT	Türkiye Radyo ve Televizyon Kurumu
TSE	Türk Standartları Enstitüsü
TSİ	Türkiye saati ile
TSK	Türk Silahlı Kuvvetleri
TSKB	Türkiye Sınai Kalkınma Bankası
TT	Türkiye Türkçesi
TTB	Türk Tabipleri Birliği
TTK	Türk Tarih Kurumu
TTKB	Talim ve Terbiye Kurulu Başkanlığı
TTOK	Türkiye Turing ve Otomobil Kurumu
TUBİM	Türkiye Uyuşturucu ve Uyuşturucu Bağımlılığını İzleme Merkezi
Tug.	Tugay
Tuğa.	Tuğamiral
Tuğg.	Tuğgeneral 
TURKSTAT	TÜİK 
TUS	Tıpta Uzmanlık Eğitimi Giriş Sınavı
TÜ	Trakya Üniversitesi
TÜBA	Türkiye Bilimler Akademisi
TÜBİTAK	Türkiye Bilimsel ve Teknolojik Araştırma Kurumu
TÜDEMSAŞ	Türkiye Demiryolu Makineleri Sanayii Anonim Şirketi
TÜFE	Tüketici f iyatları endeksi
TÜGEM	Tarımsal Üretim ve Geliştirme Genel Müdürlüğü
TÜİK	Türkiye İstatistik Kurumu
TÜLOMSAŞ	Türkiye Lokomotif ve Motor Sanayii Anonim Şirketi
Tüm.	Tümen
Tüma.	Tümamiral
Tümg.	Tümgeneral
TÜPRAŞ	Türkiye Petrol Raf inerileri Anonim Şirketi
TÜRDOK	Türkiye Dokümantasyon Merkezi
TÜRKAK	Türk Akreditasyon Kurumu
TÜRKİYE	KOOP Türkiye Millî Kooperatif ler Birliği
TÜRKKOOP	Türkiye Tarım Kredi Kooperatif leri Merkez Birliği
TÜRKSAT	Türksat Uydu Haberleşme Kablo TV ve İşletme Anonim Şirketi
TÜRKŞEKER	Türkiye Şeker Fabrikaları Anonim Şirketi
TÜRSAB	Türkiye Seyahat Acenteleri Birliği
TÜTAV	Türk Tanıtma Vakfı
TÜVASAŞ	Türkiye Vagon Sanayii Anonim Şirketi
TV	Televizyon
TYDTA	Türkiye Yatırım Destek ve Tanıtım Ajansı Başkanlığı
TZDK	Türkiye Zirai Donatım Kurumu
TZOB	Türkiye Ziraat Odaları Birliği
UA	Avrupa Birliği Eğitim ve Gençlik Programları Merkezi Başkanlığı
UAAF	Uluslararası Amatör Atletizm Federasyonu
UAD	Uluslararası Adalet Divanı
UAEA	Uluslararası Atom Enerjisi Ajansı
UAGF	Uluslararası Amatör Güreş Federasyonu
UAT	Uluslararası Af Teşkilatı
UBAK	Ulaştırma Bakanlığı
UBAM	Ulusal Bilimsel Araştırma Merkezi
UBB	Uluslararası Basın Birliği
UBE	Uluslararası Basın Enstitüsü
UBF	Uluslararası Basketbol Federasyonu
UBOK	Uluslararası Bilimsel Organizasyon Konseyi
UÇÖ	Uluslararası Çalışma Örgütü
UDÖ	Uluslararası Denizcilik Örgütü
UE	AB 
UEA	Uluslararası Enerji Ajansı
UEFA	AFFB 
UEİBB	Uluslararası Ekonomik İş Birliği Bankası
UETHF	Uluslararası Ekolojik Tarım Hareketleri Federasyonu
UFF	Uluslararası Futbol Federasyonu
UFK	Uluslararası Finansman Kurumu
UFO	Tanımlanmamış Uçan Nesne 
UHF	Ultra yüksek frekans 
UHİK	Uluslararası Hilal İslam Komitesi
UHTB	Uluslararası Hava Taşımacılığı Birliği
UİİBÖ	Uluslararası İktisadi İş Birliği Örgütü
UİKB	Uluslararası İmar ve Kalkınma Bankası
UKA	Uluslararası Kalkınma Ajansı
UKK	Uluslararası Kızılhaç Komitesi
UMT	Uluslararası Mülteci Teşkilatı
UN	BM 
UNAC	BMÇYT 
UNCTAD	BMTKK 
UNCTC	UŞM 
UNESCO	BMEBKT 
UNHCR	MYK
UNICEF	Birleşmiş Milletler Uluslararası Çocuklara Yardım Fonu 
UNIDO	BMSKÖ 
UNO	BMT 
UNRRA	BMYRİ 
UOK	Uluslararası Olimpiyat Komitesi
UÖB	Uluslararası Ödemeler Bankası
UPB	Uluslararası Posta Birliği
UPF	Uluslararası Para Fonu
UPI	UBB 
UPU	UPB 
USAŞ	Uçak Sanayi Anonim Şirketi
USF	Uluslararası Satranç Federasyonu
USHÖ	Uluslararası Sivil Havacılık Örgütü
USÖ	Uluslararası Standartlar Örgütü
UŞM	Ulusötesi Şirketler Merkezi
UTKF	Uluslararası Tarımsal Kalkınma Fonu
UTM	Uluslararası Ticaret Merkezi
UTO	Uluslararası Ticaret Odası
UÜ	Ufuk Üniversitesi
UYAÇM	Uluslararası Yatırım Anlaşmazlıkları Çözüm Merkezi
UYB	Uluslararası Yazarlar Birliği
Uzm.	Uzman
Ü	Üniversite 
ÜAK	Üniversitelerarası Kurul Başkanlığı
Üçvş.	Üstçavuş
ÜDS	Üniversitelerarası Kurul Yabancı Dil Sınavı
ÜFE	Üretici f iyatları endeksi
ünl.	Ünlem
ÜT	Üretim tarihi
Ütğm.	Üsteğmen
vb.	Ve başkası, ve başkaları, ve benzeri, ve benzerleri, ve bunun gibi
VCD	GYD 
vd.	Ve devamı, ve diğerleri
VDMK	Varlığa Dayalı Menkul Kıymetler
Vet.	Veteriner
VGM	Vakıf lar Genel Müdürlüğü
VHF	Çok yüksek frekans 
VIP	Çok önemli kişi 
vs.	Vesaire
w	Elektrik güç birimi 
WACH	BATO 
WADB	BAKB 
WAP	KED 
WCO	DGÖ 
WFC	DGK 
WHO	DSÖ 
WIPO	DFMHÖ 
WTO	DTÖ 
Y.Mim.	Yüksek mimar
Y.Müh.	Yüksek mühendis
Yay.	Yayını, yayınları
Yb.	Yarbay
YD	Yoğun disk
Yd.Sb.	Yedek subay
YDK	Yüksek Denetleme Kurulu
YDS	Yabancı Dil Sınavı
YEÖGM	Yurt Dışı Eğitim Öğretim Genel Müdürlüğü
YİBF	Yardım ve İş Birliği Fonu
YİGM	Bayındırlık ve İskân Bakanlığı Yapı İşleri Genel Müdürlüğü
İşletmeler	Genel Müdürlüğü
YKr	Yeni kuruş
YÖGM	Millî Eğitim Bakanlığı Yükseköğretim Genel Müdürlüğü
YÖK	Yükseköğretim Kurulu
YÖS	Yabancı Uyruklu Öğrenci Sınavı
Yrd. Doç.	Yardımcı Doçent
YSE	Yol, Su, Elektrik Genel Müdürlüğü
YSK	Yüksek Seçim Kurulu
YTL	Yeni Türk lirası 
YTÜ	Yeditepe Üniversitesi
Yun.	Yunanca
YURTKUR	Yükseköğrenim Kredi ve Yurtlar Kurumu
YÜ	Yalova Üniversitesi
yy.	Yüzyıl
YYÜ	Van Yüzüncü Yıl Üniversitesi
Yzb.	Yüzbaşı
zf.	Zarf
ZKÜ	Zonguldak Karaelmas Üniversitesi
zm.	Zamir
ZMO	Ziraat Mühendisleri Odası
zool.	Zooloji