bişey	bir şey
tabiki	tabii ki
hemde	hem de
yinede	yine de
değilde	değil de
bisey	bir şey
ozaman	o zaman
bencede	bence de
bişeyler	bir şeyler
okadar	o kadar
dimi	değil mi
değilmi	değil mi
birsey	bir şey
birşey	bir şey
olsada	olsa da
nolur	ne olur
olurmu	olur mu
banada	bana da
tabikide	tabii ki de
bişe	bir şey
bişey	bir şey
bişi	bir şey
bişiy	bir şey
seninde	senin de
herkez	herkes
bidaha	bir daha
bunuda	bunu da
vede	ve de
varki	var ki
olmasada	olmasa da
bikaç	bir kaç
sizinde	sizin de
biride	biri de
olarakta	olarak da
yazıkki	yazık ki
bisi	bir şey
bişi	bir şey
napcaz	ne yapacağız
napcam	ne yapacağım
napcan	ne yapacaksın
helede	hele de
diyemi	diye mi
bişeydir	bir şeydir
bakıyorumda	bakıyorum da
afedersinde	afedersin de
sagol	sağ ol
sağol	sağ ol
naparsak	ne yaparasak
naparız	ne yaparız
naparsınız	ne yaparsınız
naparım	ne yaparım
nittin	ne yaptın
bikere	bir kere
bune	bu ne
hiçbi	hiç bir
hicbi	hiç bir 
bitek	bir tek
suan	şu an
şuan	şu an
şuanda	şu anda
suanda	şu anda
suankı	şu anki
şuankı	şu anki
asılama	 aşılama
gizlicim	 gizleyeceğim    
morelimi	 moralimi
morelini	 moralini
kocamanda	 kocaman da
acıklandı	 açıklandı
saclarım	 saçlarım
boylede	 böyle de
tabide	 tabi de
simdik	 şimdi
bugun	     bugün
diliz	     değiliz
diil	     değil
kaççam	 kaçacağım
uççam	     uçacağım
çakçam	 çakacağım
yarıcan	 yaracaksın
yetisiyim	 yetişeyim
razidir	 razıdır
bi	bir
len	lan
tşk	teşekkür
tsk	teşekkür
tskler	teşekkürler
tsklr	teşekkürler
fiat	fiyat
fiatı	fiyatı
ole	öyle
öle	öyle
yav	yahu
tmm	tamam
yani	yani
siyasî  siyasi
tâbi	tabi
tabii	tabi
sene	sene
senden	senden
oldum	öldüm
oldum	oldum
durumu	durumu
yoktur	yoktur
sesi	sesi
yoktu	yoktu
islam	islam
olun	olun
il	il
ince	ince
hâli	hali
internet	internet
ucuz	ucuz
ibrahim	ibrahim
pis	pis
mali	mali
malî	malı
acil	acil
cok	çok
insanî	insani
nin	nin
camii	cami
duruyor	duruyor
iyice	iyice
ilân	ilan
girdi	girdi
samî	sami
sanayii	sanayi
cinsel	cinsel
sessiz	sessiz
sevindim	sevindim
gidin	gidin
durun	durun
sensin	sensin
saha	saha
amîn	amin
islamî	islami
idare	idare
sorunun	sorunun
seri	seri
aziz	aziz
bari	bari
hayatî	hayati
hakîm	hakim
simdi	şimdi
michel	michael
katîl	katil
oluyorum	oluyorum
lig	lig
gazî	gazi
seksi	seksi
kuru	kuru
korku	korku
bugun	bugün
maddî	maddi
iyiydi  iyiydi
